out of forest -> خارج الغابة
lift off -> يغادر
lots and lots  -> الكثير والكثير
The engines roared -> زأرت المحركات
the ship lifted off. -> انطلقت السفينة.
But sadly they didn’t get very far. -> لكن للأسف لم يبتعدوا كثيراً.
 the Dordles did what Dordles do best -> قام آل Dordles بأفضل ما يفعله Dordles
They ate till their tummies reached their chest.  -> أكلوا حتى وصلت بطونهم إلى صدرهم.
A fuel is a substance that releases useful energy when it undergoes a chemical reaction. -> الوقود مادة تطلق طاقة مفيدة عندما تخضع لتفاعل كيميائي.
when it undergoes a chemical reaction -> عندما يخضع لتفاعل كيميائي
Energy can be used to cook our food, keep us warm and make our engines run.  -> يمكن استخدام الطاقة في طهي طعامنا وتدفئتنا وتشغيل محركاتنا.
kept under pressure for millions of years.  -> ظلوا تحت الضغط لملايين السنين.
came up -> خطرت
But there was very little coal left on Earth. So they came up with a plan.  -> لكن كان هناك القليل جدًا من الفحم المتبقي على الأرض. لذلك توصلوا إلى خطة.
fallen -> سقط
done -> انتهى
He only used fallen branches, and planted more trees when he was done.  -> لقد استخدم فقط الأغصان المتساقطة ، وزرع المزيد من الأشجار عندما انتهى.
seatbelts -> حزام الامان
they would be able to leave the planet this time. -> سيكون
They started their engines, put on their seatbelts, and their ship zoomed into the sky.  -> بدأوا محركاتهم ، ووضعوا أحزمة مقاعدهم ، فارتفعت سفينتهم إلى السماء.
This time, the Dordles got far, but not far enough.  -> هذه المرة ، وصل Dordles بعيدًا ، لكن ليس بعيدًا بما يكفي.
tummies -> بطون
necks -> أعناق
They ate till their tummies touched their necks.  -> كانوا يأكلون حتى تلامس بطونهم أعناقهم.
knew -> عرف
 the Dordles knew what to do next. -> عرف Dordles ما يجب القيام به بعد ذلك.
crude oil  -> زيت خام
considered -> اعتبر
 Fuels such as coal, crude oil and natural gas are all considered fossil fuels because they originally came from fossils.  -> تعتبر أنواع الوقود مثل الفحم والنفط الخام والغاز الطبيعي وقودًا أحفوريًا لأنها أتت في الأصل من الحفريات.
leads -> يؤدي
 global warming -> الاحتباس الحرارى
melting -> ذوبان
caps -> قبعات
causing -> مما تسبب في
rise -> يعلو
climate -> مناخ
speed up -> اسرع
climate -> مناخ
Luckily -> لحسن الحظ
looking -> يبحث
dependence -> الاعتماد
fossil fuels -> الوقود الحفري
plenty -> وفرة
run out -> نفذ
 So the Dordles went looking for fuel that was there in plenty and would never run out.  -> لذلك ذهب Dordles للبحث عن الوقود الذي كان موجودًا بكثرة ولن ينفد أبدًا.
 set sail -> أبحر
 Along the way, he found -> على طول الطريق ، وجد
 Along the way -> على طول الطريق
Tides -> المد والجزر
Rivers -> الأنهار
dams -> السدود
waterfalls -> الشلالات
realised -> أدرك
wind -> ريح
harness -> ظفيرة -- تسخير
Doodle D took to the skies and realised that she could harness the energy of the wind and use it to power their ship.  -> انطلقت دودل دودل في السماء وأدركت أنها تستطيع تسخير طاقة الرياح واستخدامها لتشغيل سفينتهم.
steal -> سرقة
Sadly he didn’t make it all the way to the Sun -> للأسف لم يصل إلى الشمس
 He would travel to the Sun and steal its fire.  -> كان يسافر إلى الشمس ويسرق نيرانها.
sorts -> أنواع
geothermal energy -> الطاقة الحرارية الأرضية
atoms -> ذرات
which they got by splitting very small particles called atoms.  -> التي حصلوا عليها عن طريق شق جزيئات صغيرة جدًا تسمى الذرات.
splitting -> شق
fastened -> مثبت
seatbelts -> حزام الامان
fastened their seatbelts -> ربطوا أحزمة مقاعدهم
 lifted off -> انطلق
 zoomed away from Earth. -> ابتعد عن الأرض.
nature -> طبيعة سجية
regardless -> بغض النظر
agricultural -> زراعي
domestic -> المنزلي
agricultural -> زراعي
industrial -> صناعي
domestic -> المنزلي
waste -> يضيع
domestic waste. -> النفايات المنزلية.
Biofuel is made from agricultural, industrial and domestic waste.  -> الوقود الحيوي مصنوع من النفايات الزراعية والصناعية والمنزلية.
polluting -> تلويث
Energy from these sources is less polluting.  -> الطاقة من هذه المصادر أقل تلويثًا.
Energy from these sources is less polluting.  -> الطاقة من هذه المصادر أقل تلويثًا.
factories -> المصانع
power plants -> محطات توليد الكهرباء
fission -> الانشطار النووي
nucleus -> نواة
nuclei -> نوى
mined -> عقل
atoms -> ذرات
split -> ينقسم
renewable -> قابل للتجديد
tale -> حكاية
jog-trot -> هرولة
steady -> ثابت
ravines -> الوديان
plain -> سهل
plain -> سهل
ruin -> خراب
a sound of juddering and whirring resounded in the sky -> دوى صوت اهتزاز وطنين في السماء
a sound of juddering -> صوت حكم
whirring -> طنين
resounded -> مدوي
 and whirring resounded in the sky -> ودوى طنين في السماء
grocery -> بقالة خضروات وفواكه
whispered  -> همس
I bet it’s one of those famous celebs
I bet it’s one of those famous celebs -> أراهن أنه أحد هؤلاء المشاهير المشهورين
أراهن أنه أحد هؤلاء المشاهير المشهورين
preservatives -> مواد حافظة
wrapped -> مغطى
 wrapped up -> ملفوف
preservatives -> مواد حافظة
seem -> يبدو
bring -> احضر
issue -> مشكلة - قضية
term -> مصطلح - فصل مدرسي
view -> رأي
consider -> يعتبر
lose -> يخسر - يفقد
care -> رعاية
figure -> الشكل- شخصية
